XXXXXXXXXXXXXXX
X             X
X XX X X XX   X
X  X      X   X
X X  X  X     X
X X  X  X XXX X
X    X  X   X X
X XX XXXX     X
X             X
XXXXXXXXXXXXXXX
